15
14
000000000002220
000000000300020
000000#10300020
000000#10000000
000000#10000000
00000000003#020
00000002223#020
00000000003#020
000000#1000#020
000000#10000000
000000#10300000
000000000300020
000000000000020
000000000002220
